=map_,8,8

_clear
    .3 3 3 3 3 3 3 3
    .3 3 3 3 3 3 3 3
    .3 3 3 3 3 3 3 3
    .3 3 3 3 3 3 3 3
    .3 3 3 3 3 3 3 3
    .3 3 3 3 3 3 3 3
    .3 3 3 3 3 3 3 3
    .3 3 3 3 3 3 3 3


_short_grass
    .3 3 3 3 3 3 3 3
    .3 3 3 2 3 3 3 3
    .3 2 3 2 3 2 3 3
    .3 3 2 3 2 3 3 3
    .3 3 3 3 3 3 3 3
    .3 3 3 3 3 3 3 3
    .3 3 3 3 3 3 3 3
    .3 3 3 3 3 3 3 3

_long_grass
    .2 2 3 3 3 2 2 3
    .3 2 2 3 3 2 3 3
    .3 2 2 2 3 3 3 3
    .3 3 2 2 3 3 3 2
    .3 3 2 2 3 3 2 2
    .3 3 2 2 3 2 2 2
    .3 3 3 2 3 2 2 3
    .3 3 3 2 3 2 2 3

_flower
    .3 3 3 3 3 3 3 3
    .3 3 2 2 2 3 3 3
    .3 3 2 2 2 3 3 3
    .2 2 3 3 3 2 2 3
    .2 2 3 3 3 2 2 3
    .2 2 3 3 3 2 2 3
    .3 3 2 2 2 3 3 3
    .3 3 2 2 2 3 3 3

_fence_post
    .3 0 3 1 2 1 0 3
    .3 0 3 1 2 1 0 3
    .3 0 3 3 2 1 0 3
    .3 0 3 1 2 1 0 3
    .3 0 2 1 2 1 0 3
    .3 0 2 1 2 1 0 3
    .3 3 0 0 0 0 3 3
    .3 3 3 3 3 3 3 3

_fence_post_top
    .3 3 3 3 3 3 3 3
    .3 3 3 3 3 3 3 3
    .3 3 3 0 0 3 3 3
    .3 3 0 3 3 0 3 3
    .3 0 3 2 2 3 0 3
    .3 0 3 2 2 3 0 3
    .3 0 1 3 3 0 0 3
    .3 0 3 1 0 1 0 3

_path
    .3 2 2 2 2 2 2 3
    .2 2 2 2 2 2 2 2
    .2 2 2 2 1 2 2 2
    .2 2 2 2 2 2 2 2
    .2 1 2 2 2 2 2 2
    .2 2 2 2 2 3 2 2
    .2 2 2 2 2 2 2 2
    .3 2 2 2 2 2 2 3

_tree_11
    .3 3 3 3 3 3 3 2
    .3 3 3 3 3 2 0 0
    .3 3 3 3 0 0 1 2
    .3 3 3 0 1 2 2 2
    .3 3 0 1 2 2 2 2
    .3 2 0 1 2 2 2 1
    .3 0 1 2 2 2 1 1
    .2 0 1 2 2 2 1 1

_tree_21
    .0 0 0 0 0 0 0 0
    .1 2 2 2 2 2 2 2
    .2 2 2 2 2 3 3 3
    .2 1 2 2 3 3 3 3
    .1 1 2 2 3 3 3 3
    .1 1 2 2 2 3 3 3
    .1 1 2 2 2 2 2 2
    .1 1 1 2 2 2 2 2

_tree_31
    .0 0 0 0 0 0 0 0
    .2 2 2 1 1 1 1 1
    .2 2 2 2 1 1 2 2
    .3 2 2 2 2 1 1 2
    .3 2 2 2 2 1 1 1
    .2 2 2 2 2 1 1 1
    .2 2 2 2 2 1 1 1
    .2 2 2 2 2 1 1 1

_tree_41
    .2 3 3 3 3 3 3 3
    .0 0 2 3 3 3 3 3
    .1 1 0 0 3 3 3 3
    .2 2 1 1 0 3 3 3
    .2 2 2 1 1 0 3 3
    .1 2 2 1 1 0 2 3
    .1 2 2 2 1 1 0 3
    .1 2 2 2 1 1 0 2

_tree_12
    .0 1 1 2 2 2 1 1
    .0 1 1 2 2 2 2 1
    .0 1 1 2 2 2 2 2
    .0 1 1 2 2 2 2 2
    .0 1 1 1 2 2 2 2
    .0 1 1 1 2 2 2 2
    .0 1 1 1 1 1 2 2
    .0 1 1 1 1 1 1 1

_tree_22
    .1 1 1 1 1 2 2 2
    .1 1 1 1 1 1 1 1
    .1 1 1 1 1 1 1 1
    .2 2 1 1 1 1 1 1
    .2 2 2 2 1 1 1 1
    .2 2 2 2 2 1 1 1
    .2 2 2 2 2 2 2 2
    .2 2 2 2 2 2 2 2

_tree_32
    .2 2 2 1 1 1 1 1
    .1 1 1 1 1 1 1 1
    .1 1 1 1 1 1 1 2
    .1 1 1 1 1 2 2 2
    .1 1 1 1 2 2 2 2
    .1 1 1 2 2 2 2 2
    .2 2 2 2 2 2 2 2
    .2 2 2 2 2 2 2 2

_tree_42
    .1 2 2 2 1 1 1 0
    .2 2 2 2 1 1 1 0
    .2 2 2 2 1 1 1 0
    .2 2 2 2 1 1 1 0
    .2 2 2 2 1 1 1 0
    .2 2 2 1 1 1 1 0
    .2 2 1 1 1 1 1 0
    .1 1 1 1 1 1 1 0

_tree_13
    .0 1 1 1 1 1 1 1
    .2 0 1 1 1 1 1 1
    .2 0 1 1 1 1 1 1
    .0 2 0 1 1 1 1 1
    .0 2 2 0 1 1 1 1
    .0 1 2 2 0 0 1 1
    .2 0 0 1 1 1 0 0
    .2 2 2 0 0 0 2 2

_tree_23
    .1 1 2 2 2 2 2 2
    .1 1 1 2 2 2 2 2
    .1 1 1 1 1 2 2 2
    .1 1 1 1 1 1 1 1
    .1 1 1 1 1 1 1 1
    .1 1 1 1 1 1 1 1
    .0 0 0 1 1 1 1 1
    .2 2 1 0 1 1 1 1

_tree_33
    .2 2 2 2 2 2 1 1
    .2 2 2 2 2 1 1 1
    .2 2 2 2 1 1 1 1
    .1 1 1 1 1 1 1 1
    .1 1 1 1 1 1 1 1
    .1 1 1 1 1 1 1 1
    .1 1 1 1 1 0 0 0
    .1 1 1 1 0 1 2 2

_tree_43
    .1 1 1 1 1 1 1 0
    .1 1 1 1 1 1 0 2
    .1 1 1 1 1 1 0 2
    .1 1 1 1 1 0 2 0
    .1 1 1 1 0 2 2 0
    .1 1 0 0 2 2 1 0
    .0 0 1 1 1 0 0 2
    .2 2 0 0 0 2 2 2

_tree_14
    .3 2 2 2 0 3 3 2
    .3 2 2 0 3 3 3 2
    .3 3 0 2 3 3 2 2
    .3 3 0 2 3 2 2 2
    .3 3 0 2 2 2 1 0
    .3 3 2 0 0 0 0 1
    .3 3 3 3 3 2 2 2
    .3 3 3 3 3 3 3 3

_tree_24
    .2 2 2 2 0 1 1 1
    .2 2 2 2 2 0 0 0
    .2 1 0 2 2 3 3 3
    .1 0 0 0 2 3 3 3
    .0 1 1 0 1 2 3 3
    .1 1 1 1 0 2 2 2
    .2 1 1 1 1 0 2 2
    .3 3 2 2 2 2 0 0

_tree_34
    .1 1 1 0 2 2 2 2
    .0 0 0 2 2 2 2 2
    .2 2 2 2 2 0 1 2
    .2 2 2 2 0 0 0 1
    .2 2 2 1 0 1 1 0
    .2 2 2 0 1 1 1 1
    .2 2 0 1 1 1 1 2
    .0 0 2 2 2 2 3 3

_tree_44
    .3 3 2 0 2 2 2 3
    .3 3 3 2 0 2 2 3
    .2 3 3 3 2 0 3 3
    .2 2 3 3 2 0 3 3
    .0 1 2 2 2 0 3 3
    .1 0 0 0 0 2 3 3
    .2 2 3 3 3 3 3 3
    .3 3 3 3 3 3 3 3

_house_entrance_11
    .0 0 0 0 0 0 0 0
    .3 3 3 3 3 3 3 3
    .3 3 3 3 3 3 3 3
    .2 2 2 2 2 2 2 2
    .2 2 1 1 1 1 1 1
    .2 2 1 0 0 0 0 0
    .0 0 0 0 0 0 0 0
    .1 1 1 0 0 0 0 0

_house_entrance_21
    .0 0 0 0 0 0 0 0
    .3 3 3 3 3 3 3 3
    .3 3 3 3 3 3 3 3
    .2 2 2 2 2 2 2 2
    .1 1 1 1 1 1 2 2
    .0 0 0 0 0 1 2 2
    .0 0 0 0 0 0 0 0
    .0 0 0 0 0 1 1 1

_house_entrance_12
    .2 2 1 0 0 0 0 0
    .2 2 1 0 0 0 0 0
    .2 2 1 0 0 0 0 0
    .2 2 1 0 0 0 0 0
    .2 2 1 0 0 0 0 0
    .2 2 1 0 0 0 0 0
    .2 2 1 0 0 0 0 0
    .0 0 0 0 0 0 0 0

_house_entrance_22
    .0 0 0 0 0 2 2 1
    .0 0 0 0 0 2 2 1
    .0 0 0 0 0 2 2 1
    .0 0 0 0 0 2 2 1
    .0 0 0 0 0 2 2 1
    .0 0 0 0 0 2 2 1
    .0 0 0 0 0 2 2 1
    .0 0 0 0 0 0 0 0

_house_window_11
    .0 0 0 0 0 0 0 0
    .0 1 1 1 1 1 1 1
    .0 3 3 3 3 3 3 3
    .0 2 2 2 2 2 2 2
    .0 0 0 0 0 0 0 0
    .0 1 1 0 2 0 0 0
    .0 2 2 0 2 0 0 0
    .0 2 2 0 2 0 0 0

_house_window_21
    .0 0 0 0 0 0 0 0
    .1 1 1 1 1 1 1 0
    .3 3 3 3 3 3 3 0
    .2 2 2 2 2 2 2 0
    .0 0 0 0 0 0 0 0
    .0 0 0 2 0 1 1 0
    .0 0 0 1 0 2 2 0
    .0 0 0 1 0 2 2 0

_house_window_12
    .0 2 2 0 2 0 0 0
    .0 2 2 0 2 3 3 3
    .0 1 1 0 0 0 0 0
    .0 1 1 2 2 2 2 2
    .0 2 2 2 1 1 2 2
    .0 2 2 2 1 1 2 2
    .0 0 0 0 0 0 0 0
    .2 2 2 2 2 2 2 2

_house_window_22
    .0 0 0 2 0 2 2 0
    .3 3 3 2 0 2 2 0
    .0 0 0 0 0 2 1 0
    .3 3 2 2 2 2 1 0
    .3 3 2 1 1 2 2 0
    .2 2 2 1 1 2 2 0
    .0 0 0 0 0 0 0 0
    .2 2 2 2 2 2 2 2

_house_roof_top
    .2 1 0 0 0 0 1 2
    .1 0 1 2 2 1 0 1
    .0 1 2 3 3 2 1 0
    .0 1 2 3 3 2 1 0
    .0 1 2 3 3 2 1 0
    .0 1 2 3 3 2 1 0
    .0 1 2 3 2 2 1 0
    .0 1 2 3 3 2 1 0

_house_roof_bottom
    .0 1 2 3 3 2 1 0
    .0 1 2 3 3 2 1 0
    .0 1 2 3 3 2 1 0
    .0 1 2 2 2 2 1 0
    .0 1 1 2 2 1 1 0
    .0 1 1 1 1 1 1 0
    .1 0 1 1 1 1 0 1
    .2 1 0 0 0 0 1 2